EEEEEEEE
XXXOOXXX
X1111XXX
XXXXXXXX
X111XX1X
XXXXXXXX
