XEEEEEEE
DXXXXEOX
XXX41XOX
X44241OX
X1XXXXOX
